0220000220
0220000220
0111111110
5111000120
1133113311
1111111111
1100011111
0114411510
0011001100
0041001110