1111111111
1000000001
1033333301
1030000301
1030550301
1030220301
1030550301
1030000301
1033333301
1111111111