1111111111
1111411111
1114441111
1144444111
1444444441
1444444441
1144444111
1114441111
1111411111
1111121121