1111441111
1351111531
1501111051
1103223011
1130550311
1134443111
1501111051
1311111131
1111111111
0411551140