1111111112
1100000011
1100000011
1100000011
1100000011
1100000011
1421133432
