1140000411
1140000411
1150000511
1133333311
1111111111
1111111111
1150000511
1140200411
1140002411
1133333311