1111001111
1341001431
1435115341
0152432510
0154114510
0154114510
0152432510
1435115341
1341001431
1111001111