0220000220
0220000220
0011111110
1111111111
1133113311
1111111111
1111111111
0111111110
0011001100
0014005410