0055500550
0555555500
0233333320
0134444310
1111111111
1133113311
0011111100
0022222200
0004400000
5555555555
