1111111111
1100000011
1020000201
1030000301
1030000301
1103333011
1111111111
