0005555000
0051111500
0513333150
5132222315
5134444315
5132222315
0513333150
0051111500
0005555000
0000000000
