1111111112
1100000011
1100000011
1100000011
1100000011
1100000011
1321133332
