1100000012
1100000011
1100000011
1111121111
1100000011
1100000011
1100000012
